NO ./textures/wall4.png
SO ./textures/wall3.png
WE ./textures/hitler.png
EA ./textures/swastika.png

F 169,169,169
C 69,69,69

        1111111111111111111111111
        1000000000110000000000001
        1011000001110000000000001
        1001000000000000000000001
111111111011000001110000000000001
100000000011000001110111110111111
11110111111111010000000010001
11110111111111011101010010001
11000000110101011100000000001
10000000000000001100000010001
10000000000000001101010010001
11000001110101011111011110N0111
11110111 11101000000000000001
11111111 11111111111111111111