NO ./textures/wall1.png
SO ./textures/wall1.png
WE ./textures/wall1.png
EA ./textures/wall1.png

F 220,100,244
C 0,242,211

1111111111111111111111111
1000000000110000000000001
1011000001110000000000001
1001000000000000000000001
111111111011000001110000011
10000000001100000111011111111
11110111111111011100000010001
11110111111111011101010010001
1100000011010100000000000011
10000000000000001100000010001
11000000000000000110101001001
 1000001110101011111011110N01
11110111 1110101 101111010001
11111111 1111111 111111111111