NO ./textures/wall1.png

WE  textures/wall1.png
C 0, 242,211
EA ./textures/wall1.png
F 220, 200,244
SO   ./textures/wall1.png

1111111111111111111111111
1000000000110000000000001
1011000001110000000000001
1001000000000000000000001
111111111011000001110000011
10000000001100000111011111111
11110111111111011100000010001
11110111111111011101010010001
110000001101010000N0000000111
 100000111010111111011110011
11000000000000000110101001001
 100000111010101111101111111111
11111111111111111111111111111111
111111111111111111111 111 1111111 1111
111111111111111111111111111

